{
    "paths": [
        207, 238, 269, 268, 267, 266, 265, 232, 231, 230, 229, 228, 259, 291,
        323, 356, 357, 358, 359, 360, 329, 297, 361, 362, 363, 364, 365, 366,
        367, 368, 369, 370, 338, 306, 274, 242, 211, 217, 213, 181, 150, 119,
        120, 153, 154, 187, 219, 218, 250, 216, 215, 214, 212, 245, 276, 307,
        282, 314, 347, 379, 410, 441, 472, 471, 470, 469, 468, 467, 466, 465,
        464, 463, 462, 461, 460, 459, 490, 522, 555, 588, 557, 526, 527, 528,
        529, 530, 531, 532, 533, 534, 503, 500, 562, 593, 592, 591, 590, 589,
        619, 651, 684, 716, 749, 750, 751, 752, 785, 817, 849, 880, 879, 878,
        877, 876, 875, 874, 873, 872, 871, 870, 837, 805, 773, 711, 680, 649,
        742, 650, 617, 584, 551, 519, 487, 454, 421, 389, 504, 505, 506, 507,
        508, 509, 478, 446, 415
    ],
    "exits": [207, 415, 187]
}
